############
#J..P...##@#
#.###.#....#
#..@######.#
#@##@##....#
###@....####
############
